##################
#.##.__.##.______#
#..#.__....______#
#_.#.____________#
#_.#.__________$_#
#..#..____..@..__#
#....._____..#.__#
#__..##..___.#.__#
#__..###.___...__#
##################