##################
##.....#...###...#
#......#..$.###..#
#____.##..__.#####
#__@__.#.____..###
#__.___#.________#
#_...__..________#
#__##....._...___#
#__####........__#
##################