####################
#@....._________...#
#...###.........####
#...#.....#........#
#_..#.....#........#
#_#.......#........#
#_#...#####..#...###
#.#.......#..#.....#
#.#####...#..#.....#
#.........#..###...#
#..___..$..........#
#####..............#
#..................#
####################